i	_____
o	${i}/HybSuite_results
d	${o}/NGS_dataset
t	_____
eas_dir	${o}/01-Assembled_data
prefix	HybSuite
skip_stage	_____
tree	0
OI	1
other_seqs	_____
process	1
conda1	base
conda2	base
my_raw_data	_____
rm_sra	TRUE
download_format	fastq_gz
trimmomatic_leading_quality	3
trimmomatic_trailing_quality	3
trimmomatic_min_length	36
trimmomatic_sliding_window_s	4
trimmomatic_sliding_window_q	15
hybpiper_m	blast
hybpiper_tt	dna
hybpiper_tr	dna
hybpiper_rs	gene
hybpiper_length_filter	0
hybpiper_percent_filter	0
heatmap_color	black
min_length	0
mean_length_ratio	0
max_length_ratio	0
min_sample_coverage	0
min_locus_coverage	0
RLWP_samples_threshold	1
mafft_algorithm	auto
mafft_adjustdirection	TRUE
run_paragone	FALSE
oi_tree	fasttree
paragone_tree	fasttree
paragone_pool	1
paragone_treeshrink_q_value	0.05
paragone_cutoff_value	0.03
paragone_minimum_taxa	4
paragone_min_tips	4
run_phylopypruner	FALSE
pp_prune	LS
pp_min_taxa	4
pp_min_support	0
pp_trim_lb	5
replace_n	FALSE
trimal_mode	automated1
trimal_block	_____
trimal_w	_____
trimal_gw	_____
trimal_sw	_____
trimal_resoverlap	_____
trimal_seqoverlap	_____
trimal_gapthreshold	_____
trimal_simthreshold	_____
trimal_cons	_____
run_modeltest_ng	TRUE
iqtree_partition	TRUE
iqtree_bb	1000
iqtree_constraint_tree	_____
iqtree_run_option	undo
iqtree_alrt	1000
raxml_m	GTRGAMMA
raxml_bb	1000
raxml_constraint_tree	_____
rng_bs_trees	1000
rng_force	FALSE
rng_constraint_tree	_____
nt	_____
nt_fasterq_dump	10
nt_pigz	10
nt_trimmomatic	10
nt_hybpiper	10
nt_paragone	10
nt_phylopypruner	10
nt_mafft	10
nt_modeltest_ng	10
nt_iqtree	10
nt_raxml_ng	10
nt_raxml	10
nt_astral	10
nt_wastral	1
wastral_mode	1
wastral_dir	_____
wastral_R	4
wastral_S	4
run_sortadate	FALSE
sortadate_genes_num	25
log_mode	cmd
skip_genetree_for_coalescent	FALSE
